{
  "enemies": [

  ],
  "collectables": [
    { "type": "PowerUp", "x": 25, "y": 4 },
    { "type": "PowerUp", "x": 40, "y": 3 }
  ],
  "mapHeight": 8,
  "mapWidth": 50,
  "tileMap": [
    [ 0, 0, 0, 0, 0, 0, 0, 0, 0, 0, 0, 0, 0, 0, 0, 0, 0, 0, 0, 0, 0, 0, 0, 0, 0, 0, 0, 0, 0, 0, 0, 0, 0, 0, 0, 0, 0, 0, 0, 0, 0, 0, 0, 0, 0, 0, 0, 0, 0, 0 ],
    [ 0, 0, 0, 0, 0, 0, 0, 0, 0, 0, 0, 0, 0, 0, 0, 0, 0, 0, 0, 0, 0, 0, 0, 0, 0, 0, 0, 0, 0, 0, 0, 0, 0, 0, 0, 0, 0, 0, 0, 0, 0, 0, 0, 0, 0, 0, 0, 0, 0, 0 ],
    [ 0, 0, 0, 0, 0, 0, 0, 0, 0, 0, 0, 0, 0, 0, 0, 0, 0, 0, 0, 0, 0, 0, 0, 0, 0, 0, 0, 0, 0, 0, 0, 0, 0, 0, 0, 0, 0, 0, 0, 0, 0, 0, 0, 0, 0, 0, 0, 0, 0, 0 ],
    [ 0, 0, 0, 0, 0, 0, 0, 0, 0, 0, 0, 1, 2, 3, 0, 0, 0, 0, 0, 0, 0, 0, 0, 0, 0, 0, 0, 0, 0, 0, 0, 0, 0, 0, 0, 0, 0, 0, 0, 0, 0, 0, 0, 0, 0, 0, 0, 0, 0, 0 ],
    [ 0, 0, 0, 0, 0, 0, 0, 0, 0, 0, 0, 0, 0, 0, 0, 0, 0, 0, 0, 1, 2, 2, 3, 0, 0, 0, 0, 0, 0, 0, 0, 0, 0, 0, 0, 0, 0, 1, 2, 2, 3, 0, 0, 0, 0, 0, 0, 0, 0, 0 ],
    [ 0, 0, 0, 0, 0, 1, 2, 3, 0, 0, 0, 0, 0, 0, 0, 0, 0, 0, 1, 8, 5, 5, 10, 3, 0, 0, 0, 0, 0, 0, 0, 0, 0, 0, 0, 0, 1, 8, 5, 5, 10, 3, 0, 0, 0, 0, 0, 0, 0, 0 ],
    [ 0, 0, 0, 1, 2, 8, 5, 10, 2, 3, 0, 0, 0, 0, 0, 0, 0, 1, 8, 5, 5, 5, 5, 10, 3, 0, 0, 0, 0, 0, 0, 0, 0, 0, 0, 1, 8, 5, 5, 5, 5, 10, 3, 0, 0, 0, 0, 0, 0, 0 ],
    [ 2, 2, 2, 2, 5, 5, 5, 5, 5, 2, 2, 2, 2, 2, 0, 0, 2, 2, 5, 5, 5, 5, 5, 5, 2, 2, 0, 0, 2, 2, 2, 2, 0, 0, 2, 2, 5, 5, 5, 5, 5, 5, 2, 2, 17, 17, 17, 17, 2, 2 ]
  ]
}
