{
  enemies: [
    {
      type: Orco
      x: 17
      y: 1
    }
  ],
  collectables: [
    {
      "type": PowerUp
      "x": 21
      "y": 1
    }
  ],
  mapHeight: 8
  mapWidth: 50
  tileMap: [
    [ 0, 0, 0, 0, 0, 0, 0, 0, 0, 0, 0, 0, 0, 0, 0, 0, 0, 0, 0, 0, 0, 0, 0, 0, 0, 0, 0, 0, 0, 0, 0, 0, 0, 0, 0, 0, 0, 0, 0, 0, 0, 0, 0, 0, 0, 0, 0, 0, 0, 0 ]
    [ 0, 0, 0, 0, 0, 0, 0, 0, 0, 0, 0, 0, 0, 0, 0, 0, 0, 0, 0, 0, 0, 0, 0, 0, 0, 0, 0, 0, 0, 0, 0, 0, 0, 0, 0, 0, 0, 0, 0, 0, 0, 0, 0, 0, 0, 0, 0, 0, 0, 0 ]
    [ 0, 0, 0, 0, 0, 0, 0, 0, 0, 0, 0, 0, 0, 0, 0, 0, 0, 0, 0, 0, 1,3,0, 0, 0, 0, 0, 0, 0, 0, 0, 0, 0, 1,2,2,3,0, 0, 0, 0, 0, 0, 0, 0, 0, 0, 0, 0, 0 ]
    [ 0, 0, 0, 0, 0, 0, 0, 0, 0, 0, 0, 0, 0, 0, 0, 0, 0, 0, 0, 0, 0, 0, 0, 0, 0, 0, 0, 0, 0, 0, 0, 0, 0, 0, 0, 0, 0, 0, 1,2,3,0, 0, 0, 0, 0, 0, 0, 0, 0 ]
    [ 0, 0, 0, 0, 0, 0, 0, 0, 0, 0, 0, 1, 3, 0, 0, 0, 0, 0, 1,2,2,2,2,3,0, 0, 0, 0, 0, 1,2,3,0, 0, 0, 0, 0, 0, 0, 0, 0, 0, 0, 0, 0, 0, 0, 0, 0, 1 ]
    [ 0, 0, 0, 0, 0, 0, 0, 0, 0, 0, 1, 8, 10,3, 0, 0, 0, 0, 0, 0, 0, 0, 0, 0, 0, 0, 0, 0, 0, 0, 0, 0, 0, 0, 0, 0, 0, 0, 0, 0, 0, 2, 3, 0, 0, 0, 0, 0, 1, 8 ]
    [ 0, 0, 0, 0, 0, 0, 0, 0, 0, 1, 8, 5, 5, 10,3, 0, 0, 0, 0, 0, 0, 0, 0, 0, 0, 0, 1, 3, 17,17,17,17,17,17,17,17,17,17,17,17,8, 10,2,2, 2, 2, 2, 2, 8, 5 ]
    [ 2, 2, 2, 2, 2, 2, 2, 2, 2, 8, 5, 5, 5, 5, 10,2,2, 2, 2, 2, 2, 2, 2, 2, 2, 2, 8, 10, 18,18,18,18,18,18,18,18,18,18,18,18,5, 5, 5, 5, 5, 5, 5, 5, 5, 5 ]
  ]
}
