{
  enemies: [
    {
      type: Turtle
      x: 11
      y: 1
    }
    {
      type: Turtle
      x: 9
      y: 1
    }
  ],
  mapHeight: 8
  mapWidth: 30
  tileMap: [
    [ 0, 0, 0, 0, 0, 0, 0, 0, 0, 0, 0, 0, 0, 0, 0, 0, 0, 0, 0, 0, 0, 0, 0, 0, 0, 0, 0, 0, 0, 0 ]
    [ 0, 0, 0, 0, 0, 0, 0, 0, 0, 0, 0, 0, 0, 0, 0, 0, 0, 0, 0, 0, 0, 0, 0, 0, 0, 0, 0, 0, 0, 0 ]
    [ 0, 0, 0, 0, 0, 0, 0, 0, 0, 0, 0, 0, 0, 0, 0, 0, 0, 0, 0, 0, 13, 15, 0, 0, 0, 0, 0, 0, 0, 0 ]
    [ 0, 0, 0, 0, 0, 0, 0, 0, 0, 0, 0, 0, 0, 0, 0, 0, 0, 0, 0, 0, 0, 0, 0, 0, 0, 0, 0, 0, 0, 0 ]
    [ 0, 0, 0, 0, 0, 0, 0, 0, 0, 0, 0, 1, 3, 0, 0, 0, 0, 0, 13, 14, 14, 14, 14, 15, 0, 0, 0, 0, 0, 0 ]
    [ 0, 0, 0, 0, 0, 0, 0, 0, 0, 0, 1, 8, 10, 3, 0, 0, 0, 0, 0, 0, 0, 0, 0, 0, 0, 0, 0, 0, 0, 0 ]
    [ 0, 0, 0, 0, 0, 0, 0, 0, 0, 1, 8, 5, 5, 10, 3, 0, 0, 0, 0, 0, 0, 0, 0, 0, 0, 0, 1, 3, 17, 17 ]
    [ 2, 2, 2, 2, 2, 2, 2, 2, 7, 8, 5, 5, 5, 5, 10, 11, 2, 2, 2, 2, 2, 2, 2, 2, 2, 7, 8, 6, 18, 18 ]
  ]
}
